####################################
#--@-------------------------------#
#-------------------------#####----#
#----#----------------#-------#----#
#----######-----------#-------#----#
#---------######------#####---#----#
#--------------#-----!-------------#
#------##------------------#####---#
#------##------#------######-------#
#--------------------------------*-#
####################################
