####################################
#-----------#----------------------#
#----#------#----------------------#
#----#------#-----*-----#----------#
#----#----#####--------######------#
#----#-----------------#-----------#
#-----------#-----###--------------#
#--------####------#---------------#
#-----------#------#---------------#
#----------------------------------#
####################################
