####################################
#-----------#----------------------#
#----#------#----------------------#
#----#------#----------#-----------#
#----#----#####--------######------#
#----#-----------------#-----------#
#-----------#-----###--------------#
#--------####------#---------------#
#-----------#------#---------------#
#----------------------------------#
####################################
