####################################
#@-##------------------------------#
#---#--------##--------------##----#
#---##-------##---#-----##---#-----#
#-------#---------#-----##---##----#
#-------###------!###-------------*#
#--###------------#-----##---#-----#
#--#-------###----#----------#-----#
#--##------###-------##---####-----#
#----------------------------------#
####################################
