####################################
#--##------------------------------#
#---#--------------*---------------#
#---##------------------##---------#
#-------#---------------#----------#
#-------###-------###--------------#
#--###------------#----------#-----#
#--#--------------#----------#-----#
#--##---------------------####-----#
#----------------------------------#
####################################
