####################################
#----------------------------------#
#-------------------------#####----#
#---------------------#-------#----#
#----######------*----#-------#----#
#---------######------#####---#----#
#----------------------------------#
#--------------------------#####---#
#---------------------######-------#
#----------------------------------#
####################################
