####################################
#-*---------#----------------------#
#----#------#----------------------#
#----#------#-----!----#-----------#
#----#----#####--------######------#
#----#-----------------#-----------#
#-----------#-----###----###-------#
#--------####------#-----###---##--#
#-----------#------#-----------##--#
#---------------------------------@#
####################################
