####################################
#--#-------------------------------#
#---#------------------------------#
#----#------------------##---------#
#-----------------------#----------#
####################################
